wwww0000
ww000000
w0w00000
w00w0000
0000w000
00000w00
000000ww
000000w0
