00000000
00000000
0000000W
00W00000
000W000W
00000000
00000000
00000000
