000ww000
00w00w00
0w0000w0
w00ww00w
w00ww00w
0w0000w0
00w00w00
000ww000